#######################################
# Keywords for ODriveArduino Library
#######################################

# Classes (KEYWORD1 - Naranja)
ODriveArduino	KEYWORD1

#######################################

# Functions (KEYWORD2 - Marr√≥n)
ClearErrors	KEYWORD2
EraseConfig	KEYWORD2
GetFeedback	KEYWORD2
GetFeedbackBoth	KEYWORD2
GetPosition	KEYWORD2
GetVelocity	KEYWORD2
ReadProperty	KEYWORD2
Reboot	KEYWORD2
SaveConfig	KEYWORD2
SendCommand	KEYWORD2
SetCurrent	KEYWORD2
SetPosition	KEYWORD2
SetVelocity	KEYWORD2
SetVelocityBoth	KEYWORD2
SetVelocityBoth_GetFeedback	KEYWORD2
SetVelocityBoth_GetFeedback_Vbus	KEYWORD2
SetVelocityBoth_GetVbus	KEYWORD2
TrapezoidalMove	KEYWORD2
WaitIdle	KEYWORD2
WriteProperty	KEYWORD2
readFloat	KEYWORD2
readInt	KEYWORD2
run_state	KEYWORD2

#######################################

# Constants & Enums (LITERAL1 - Azul)

# ODrive.Axis.AxisState
AXIS_STATE_UNDEFINED	LITERAL1
AXIS_STATE_IDLE	LITERAL1
AXIS_STATE_STARTUP_SEQUENCE	LITERAL1
AXIS_STATE_FULL_CALIBRATION_SEQUENCE	LITERAL1
AXIS_STATE_MOTOR_CALIBRATION	LITERAL1
AXIS_STATE_ENCODER_INDEX_SEARCH	LITERAL1
AXIS_STATE_ENCODER_OFFSET_CALIBRATION	LITERAL1
AXIS_STATE_CLOSED_LOOP_CONTROL	LITERAL1
AXIS_STATE_LOCKIN_SPIN	LITERAL1
AXIS_STATE_ENCODER_DIR_FIND	LITERAL1
AXIS_STATE_HOMING	LITERAL1
AXIS_STATE_ENCODER_HALL_POLARITY_CALIBRATION	LITERAL1
AXIS_STATE_ENCODER_HALL_PHASE_CALIBRATION	LITERAL1
AXIS_STATE_ANTICOGGING_CALIBRATION	LITERAL1

# ODrive.Controller.ControlMode
CONTROL_MODE_VOLTAGE_CONTROL	LITERAL1
CONTROL_MODE_TORQUE_CONTROL	LITERAL1
CONTROL_MODE_VELOCITY_CONTROL	LITERAL1
CONTROL_MODE_POSITION_CONTROL	LITERAL1

# ODrive.Controller.InputMode
INPUT_MODE_INACTIVE	LITERAL1
INPUT_MODE_PASSTHROUGH	LITERAL1
INPUT_MODE_VEL_RAMP	LITERAL1
INPUT_MODE_POS_FILTER	LITERAL1
INPUT_MODE_MIX_CHANNELS	LITERAL1
INPUT_MODE_TRAP_TRAJ	LITERAL1
INPUT_MODE_TORQUE_RAMP	LITERAL1
INPUT_MODE_MIRROR	LITERAL1
INPUT_MODE_TUNING	LITERAL1

# ODrive.Error
ODRIVE_ERROR_NONE	LITERAL1
ODRIVE_ERROR_INITIALIZING	LITERAL1
ODRIVE_ERROR_SYSTEM_LEVEL	LITERAL1
ODRIVE_ERROR_TIMING_ERROR	LITERAL1
ODRIVE_ERROR_MISSING_ESTIMATE	LITERAL1
ODRIVE_ERROR_BAD_CONFIG	LITERAL1
ODRIVE_ERROR_DRV_FAULT	LITERAL1
ODRIVE_ERROR_MISSING_INPUT	LITERAL1
ODRIVE_ERROR_DC_BUS_OVER_VOLTAGE	LITERAL1
ODRIVE_ERROR_DC_BUS_UNDER_VOLTAGE	LITERAL1
ODRIVE_ERROR_DC_BUS_OVER_CURRENT	LITERAL1
ODRIVE_ERROR_DC_BUS_OVER_REGEN_CURRENT	LITERAL1
ODRIVE_ERROR_CURRENT_LIMIT_VIOLATION	LITERAL1
ODRIVE_ERROR_MOTOR_OVER_TEMP	LITERAL1
ODRIVE_ERROR_INVERTER_OVER_TEMP	LITERAL1
ODRIVE_ERROR_VELOCITY_LIMIT_VIOLATION	LITERAL1
ODRIVE_ERROR_POSITION_LIMIT_VIOLATION	LITERAL1
ODRIVE_ERROR_WATCHDOG_TIMER_EXPIRED	LITERAL1
ODRIVE_ERROR_ESTOP_REQUESTED	LITERAL1
ODRIVE_ERROR_SPINOUT_DETECTED	LITERAL1
ODRIVE_ERROR_BRAKE_RESISTOR_DISARMED	LITERAL1
ODRIVE_ERROR_THERMISTOR_DISCONNECTED	LITERAL1
ODRIVE_ERROR_CALIBRATION_ERROR	LITERAL1

# ODrive.MotorType
MOTOR_TYPE_HIGH_CURRENT	LITERAL1
MOTOR_TYPE_GIMBAL	LITERAL1
MOTOR_TYPE_ACIM	LITERAL1

# ODrive.Can.Protocol
PROTOCOL_NONE	LITERAL1
PROTOCOL_SIMPLE	LITERAL1

# ODrive.EncoderId
ENCODER_ID_NONE	LITERAL1
ENCODER_ID_INC_ENCODER0	LITERAL1
ENCODER_ID_INC_ENCODER1	LITERAL1
ENCODER_ID_INC_ENCODER2	LITERAL1
ENCODER_ID_SENSORLESS_ESTIMATOR	LITERAL1
ENCODER_ID_SPI_ENCODER0	LITERAL1
ENCODER_ID_SPI_ENCODER1	LITERAL1
ENCODER_ID_SPI_ENCODER2	LITERAL1
ENCODER_ID_HALL_ENCODER0	LITERAL1
ENCODER_ID_HALL_ENCODER1	LITERAL1
ENCODER_ID_RS485_ENCODER0	LITERAL1
ENCODER_ID_RS485_ENCODER1	LITERAL1
ENCODER_ID_RS485_ENCODER2	LITERAL1
ENCODER_ID_ONBOARD_ENCODER0	LITERAL1
ENCODER_ID_ONBOARD_ENCODER1	LITERAL1

# ODrive.SpiEncoderMode
SPI_ENCODER_MODE_DISABLED	LITERAL1
SPI_ENCODER_MODE_RLS	LITERAL1
SPI_ENCODER_MODE_AMS	LITERAL1
SPI_ENCODER_MODE_CUI	LITERAL1
SPI_ENCODER_MODE_AEAT	LITERAL1
SPI_ENCODER_MODE_MA732	LITERAL1
SPI_ENCODER_MODE_TLE	LITERAL1
SPI_ENCODER_MODE_BISSC	LITERAL1

# ODrive.GpioMode
GPIO_MODE_DIGITAL	LITERAL1
GPIO_MODE_DIGITAL_PULL_UP	LITERAL1
GPIO_MODE_DIGITAL_PULL_DOWN	LITERAL1
GPIO_MODE_ANALOG_IN	LITERAL1
GPIO_MODE_UART_A	LITERAL1
GPIO_MODE_UART_B	LITERAL1
GPIO_MODE_UART_C	LITERAL1
GPIO_MODE_CAN_A	LITERAL1
GPIO_MODE_I2C_A	LITERAL1
GPIO_MODE_SPI_A	LITERAL1
GPIO_MODE_PWM	LITERAL1
GPIO_MODE_ENC0	LITERAL1
GPIO_MODE_ENC1	LITERAL1
GPIO_MODE_ENC2	LITERAL1
GPIO_MODE_MECH_BRAKE	LITERAL1
GPIO_MODE_STATUS	LITERAL1
GPIO_MODE_BRAKE_RES	LITERAL1
GPIO_MODE_AUTO	LITERAL1